###########################################################################
#S#     #       # #             #                           #     #   #   #
# ##### # ### # # # ##### ##### ##################### ### ### # ### # # # #
# #   #     # # #   #   #     #   #           #     #   # #   #   # #   # #
# # # ##### # # ##### # ##### ### # ######### # ### ### ### ##### # ##### #
#   #     # # #   #   #       # #   #       # # # #   #     #   #       # #
######### ### ### # ########### ##### # ##### # # ### ##### # # ######### #
# #     # #   # # # #     #     #     #       # #     #   #   #     #     #
# # # ### # ### # # # ### # ### # ############# # ##### # ########### ### #
#   #       #       #   #     #                 #       #             #  E#
###########################################################################